_____5X__
_5H_  ___
H __5_H__
H____  _H
__S____H_
