_____X_____
HHHHHHHHHHH
HHHHHHHHHHH
HHHHHHHHHHH
HHHHHHHHHHH
HHHHHHHHHHH
HHHHHHHHHHH
HHHHHSHHHHH